"a" = (/turf/floor,/area)
"b" = (/mob{ai = 0},/turf/floor,/area)
"c" = (/obj/item/weapon/dagger,/turf/floor,/area)

(1,1,1) = {"
aaaaaaaaaaaaaa
aaaaaaaaaaaaaa
aaaaaaaaaaaaaa
aaaaaaaaaaaaaa
aaaaaaaaaaaaaa
aaaaaaaabaaaaa
aaaaaaaaaaaaaa
aaaaaaacaaaaaa
aaaaaaaaaaaaaa
aaaaaaaaaaaaaa
aaaaaaaaaaaaaa
aaaaaaaaaaaaaa
aaaaaaaaaaaaaa
aaaaaaaaaaaaaa
"}
