"a" = (/turf/floor,/area)
"b" = (/obj/item/weapon/dagger,/turf/floor,/area)
"c" = (/mob,/turf/floor,/area)

(1,1,1) = {"
aaaaaaaaaaaaaa
aaaaaaaaaaaaaa
aaaaaaaaaaaaaa
aaaaaaaaaaaaaa
aaaaaaaaaaaaaa
aaabaaaaaaaaaa
aaaaaaaaaaaaaa
aaaaaaabaaaaaa
aaaaaaaaaaaaaa
aaaaaaaaaaaaaa
aaaaaaaaaaaaaa
aaaaaaaaaaaaaa
aaaaaaaaaaaaaa
aacaaaaaaaaaaa
"}
