"a" = (/turf/floor,/area)
"b" = (/obj/item/weapon/dagger,/turf/floor,/area)
"c" = (/obj/item/armor/breastplate,/turf/floor,/area)
"d" = (/mob,/turf/floor,/area)

(1,1,1) = {"
aaaaaaaaaaaaaa
aaaaaaaaaaaaaa
aaaaaaaaaaaaaa
aaaaaaaaaaaaaa
aaaaaaaaaaaaaa
aaabaaaaaaaaaa
aaaaaaaacaaaaa
aaaaaaabaaaaaa
aaaaaaaaaaaaaa
aaaaaaaaaaaaaa
aaaaaaaaaaaaaa
aaaaaaaaaaaaaa
aaaaaaaaaaaaaa
aadaaaaaaaaaaa
"}
