"a" = (/turf/floor,/area)
"b" = (/obj/item/weapon/sword,/turf/floor,/area)
"c" = (/mob{ai = 0},/turf/floor,/area)

(1,1,1) = {"
aaaaaaaaaaaaaa
aaaaaaaaaaaaaa
aaaaaaaaaaaaaa
aaaaaaaaaaaaaa
aaaaabaaaaaaaa
aaaaaaaacaaaaa
aaaaaaaaaaaaaa
aaaaaaaaaaaaaa
aaaaaaaaaaaaaa
aaaaaaaaaaaaaa
aaaaaaaaaaaaaa
aaaaaaaaaaaaaa
aaaaaaaaaaaaaa
aaaaaaaaaaaaaa
"}
