"a" = (/turf/floor,/area)
"b" = (/obj/item/weapon/sword,/turf/floor,/area)
"c" = (/obj/item/weapon/spear,/turf/floor,/area)
"d" = (/mob{ai = 0},/turf/floor,/area)

(1,1,1) = {"
aaaaaaaaaaaaaa
aaaaaaaaaaaaaa
aaaaaaaaaaaaaa
aaaaaaaaaaaaaa
aaaaabaaaaaaaa
aaaaaacadaaaaa
aaaaaaaaaaaaaa
aaaaaaaaaaaaaa
aaaaaaaaaaaaaa
aaaaaaaaaaaaaa
aaaaaaaaaaaaaa
aaaaaaaaaaaaaa
aaaaaaaaaaaaaa
aaaaaaaaaaaaaa
"}
